1.まえかぎ　　前言
2.できたわけ   完成或者实现的理由
3.解説　　かいせつ
4．入門にゅうもん
5.A - エー (ē)
B - ビー (bī)
C - シー (shī)
D - ディー (dī)
E - イー (ī)
F - エフ (efu)
G - ジー (jī)
H - エイチ (eichi)
I - アイ (ai)
J - ジェイ (jei)
K - ケー (kē)
L - エル (eru)
M - エム (emu)
N - エン (en)
O - オー (ō)
P - ピー (pī)
Q - キュー (kyū)
R - アール (āru)
S - エス (esu)
T - ティー (tī)
U - ユー (yū)
V - ブイ (bui)
W - ダブリュー (daburyū)
X - エックス (ekkusu)
Y - ワイ (wai)
Z - ゼット (zetto)
